NO ./textures/textura1.xpm
SO ./textures/textura2.xpm
WE ./textures/wall.xpm
EA ./textures/wall2.xpm

F 231,  156,    29
C 38,141,11
1                1
  
 11111111111
1000000000001
1000000100001
1000100000001
1001000010001
1000000000001
1000000000001
100000S000001
1000100000001
1001000010001
1000000010001
1000000000001
1000000000001
 11111111111