NO ./textures/using/enredadera.xpm
WE ./textures/using/brickrosa.xpm
SO ./textures/using/brickamarillo.xpm
EA ./textures/using/ventana.xpm

F 214,194,133
C 152,245,239
1111111111111111111111111111
1000000000000000000000000001
1000000000000000000000000001
1000000000000000000000000001
1000000111100000001111111111
1000001111110000000000000001
1000001111110000001111111111
1000001111110000000000000001
1000001111110000001111111111
1000000000000000000000000001
10000S0000000000000000000001
1000000000000000000000000001
1000000000000000000000000001
1000000000000000000000000001
1000011111111000000000000001
1001111111111000000000000001
1001111111111000011111111111
1000000000000000000000000011
1111111111111111111111111111
